  XXXXXXXXXXXXXXXXXXX
X X                 X
X X X XXXXXXXXXXXXX X
X X X X         X   X
X XXX X XXXXXXX X XXX
X     X     X X   X X
XXXXXXXXXXX X XXXXX X
X X         X   X   X
X X XXXXXXXXX X X X X
X X         X X X X X
X XXXXXXXXX X X XXX X
X   X     X X X   X X
X X X XXX X X XXX X X
X X X X X   X   X X X
X XXX X XXXXXXX X X X
X     X         X X X
X XXXXX XXXXXXXXX X X
X   X       X   X X X
XXX XXXXXXX X XXX X X
X           X       X
XXXXXXXXXXXXXXXXXXX  
